11,15
+++++++++++++++
+b+   + + +   +
+ +++ + + +++ +
+   +   +     +
+ + + +++ +++ +
+ +   +     + +
+ +++++ +++++ +
+       +     +
+++ + +++++ +++
+            c+
+++++++++++++++